=========..=========
=.p...............G=
=.=.============.=.=
=.=.=...====...=.=.=
=.=...=......=...=.=
=.================.=
=.=..............=.=
=.=======..=======.=
=.......==.=.......=
=.=====.=..=.=====.=
........=.==........
=.=====.=..=.=====.=
=.=g..=......=g..=.=
=.=...=.====.=...=.=
=.=..............=.=
=.=...=.====.=...=.=
=.=...=.=  =.=...=.=
=.=====.====.=====.=
=......H...........=
=========..=========
